"Name"	"Surname"	"E-mail"
"Fahima"	"Allen"	"Fahima.Allen@mail.ru"
"Eryk"	"Conway"	"Eryk.Conway@gmail.com"
"Elora"	"Archer"	"Elora.Archer@ya.ru"
"Juanita"	"Ellwood"	"Juanita.Ellwood@mail.ru"
"Nasir"	"Ayers"	"Nasir.Ayers@gmail.com"
"Rickie"	"Moon"	"Rickie.Moon@ya.ru"
"Keelan"	"Wilder"	"Keelan.Wilder@mail.ru"
"Vienna"	"Sanchez"	"Vienna.Sanchez@gmail.com"
"Kiyan"	"Estrada"	"Kiyan.Estrada@ya.ru"
"Vijay"	"Shah"	"Vijay.Shah@mail.ru"
"Hania"	"Tang"	"Hania.Tang@gmail.com"
"Rhiann"	"Barton"	"Rhiann.Barton@ya.ru"
"Maeve"	"Sanders"	"Maeve.Sanders@mail.ru"
"Nela"	"Holland"	"Nela.Holland@gmail.com"
"Sharmin"	"Frazier"	"Sharmin.Frazier@ya.ru"
"Abel"	"Church"	"Abel.Church@mail.ru"
"Dave"	"Bowden"	"Dave.Bowden@gmail.com"
"Charlene"	"Yang"	"Charlene.Yang@ya.ru"
"Elsie-rose"	"Waters"	"Elsie-Rose.Waters@mail.ru"
"Bjorn"	"Vaughn"	"Bjorn.Vaughn@gmail.com"
